enemy_type,shot_type,move_pattern,shot_pattern,in_time,stop_time,shot_time,out_time,x,y,speed,HP,Item
1,0,1,0,30,0,91,300,50,-40,4,1,0
1,0,1,0,60,0,121,340,100,-40,4,2,0
1,0,1,0,90,0,151,380,150,-40,4,1,0
1,0,1,0,120,0,181,420,200,-40,4,2,0
1,0,1,0,150,0,211,460,250,-40,4,1,0
