enemy_type,shot_type,move_pattern,shot_pattern,in_time,stop_time,shot_time,out_time,x,y,speed,HP,Item
1,0,3,1,60,120,121,300,50,-40,4,1,0
1,0,3,1,120,180,181,340,100,-40,4,2,0
1,0,3,1,180,240,241,380,150,-40,4,1,0
1,0,3,1,240,300,301,420,200,-40,4,2,0
1,0,3,1,300,360,361,460,250,-40,4,1,0
